NO ./textures/wall.xpm
SO ./textures/wall.xpm
WE ./textures/wall.xpm
EA ./textures/wall.xpm
DOOR ./textures/door.xpm

C 225,0,0
F 0,0,255

BEGIN SPRITES
END SPRITES

BEGIN POS
END POS

111111111111111111111
100000010000100000001
1000N0010111100000001
100000010000100000001
111000000000100C00011
111111000011111000011
11110000O000000000011
100000011110001111111
111101111000000000001
111111111111111111111

