NO ./textures/orange_purple_bricks.xpm
SO ./textures/blue_bricks.xpm
WE ./textures/yellow_bricks.xpm
EA ./textures/grey_purple_bricks.xpm
D ./textures/crimson_door.xpm
F 198, 97, 237
C 74, 232, 182
1111
1N01
1111
