NO ./textures/orange_purple_bricks.xpm
SO ./textures/blue_bricks.xpm
WE ./textures/yellow_bricks.xpm
EA ./textures/grey_purple_bricks.xpm
D ./textures/brown_door.xpm

F  198, 97, 237
C 74, 232, 182

         111111111111111111111111
         100000000000000000000001
         101  1100111111111111101
         101  1001            101
         10111001             101
         1000001     1111111111D1111111111
111111111100011      100000000000000000001
1000000000001       1100000000000000000001
1011100011101      10000000000010000000001
101000000010111111111000000000111000000001
100000E00000D0000000D000000011111110000001
101000000010111111111000000000111000000001
1011100011101      10000000000010000000001
1000000000001       1100000000000000000001
1111111111111        100000000000000000001
                     111111111111111111111
