NO ./textures/default/wall_1.xpm
SO ./textures/default/wall_1.xpm
WE ./textures/default/wall_1.xpm
EA ./textures/default/wall_1.xpm

D ./textures/default/door.xpm

F 220,100,0
C 225,30,0

                 11111111111111111111111111
    111111111111110101
111110000001111111111
10000000111111
1000S0001
100000001
100000001
100000001
111111111
