NO ./ruta_a_la_textura_norte

SO   ./ruta_a_la_textura_sur

WE      ./ruta_a_la_textura_oeste
EA ./ruta_a_la_textura_este

D ./ruta_a_la_puerta

   F 220,100,0
C 225,30,0

                            111111111111111111
                                1111111111111111
 1111111111111111111111111111111111
10000000111111
1000S0001
100000001
100000001
100000001
111111111
