NO ./textures/custom/blue_bricks.xpm
SO ./textures/custom/115_green_bricks.xpm
WE ./textures/custom/red_bricks.xpm
EA ./textures/custom/orange_purple_bricks.xpm

D ./textures/custom/crimson_door.xpm

F 220,100,0
C 225,30,0

111111111
1001D1001
100000001
100000001
1000S0001
100000001
100000001
100000001
111111111
