NO ./textures/orange_purple_bricks.xpm
WE ./textures/115_green_bricks.xpm
SO ./textures/blue_bricks.xpm
EA ./textures/red_bricks.xpm

D ./textures/crimson_door.xpm

F  198, 97, 237
C 74, 232, 182

111111111
1001D1001
100000001
100000001
1000N0001
100000001
100000001
100000001
111111111
