NO ./textures/orange_purple_bricks.xpm
SO ./textures/blue_bricks.xpm
WE ./textures/yellow_bricks.xpm
EA ./textures/grey_purple_bricks.xpm
D ./textures/brown_door.xpm
F 198, 97, 237
C 74, 232, 182

        1111111111111111111111111
        1000010000110000000000001
        1011000001110000000000001
        1001000000100000000000001
111111111011000001  11000000000001
100000N00011000001110111111111111
11110111111111011100000010001
11111011111111101 101010010001
11000000110101011100000010001
11111111111111111111111111111
1 1
11111111111111111111111111111
10000000000000011000000100001
1000000000000001101010010D01
11000001110101011111011110011
11110111 1110101 101111010001
11111111 1111111 111111111111
1111111111111111111111111
111
111
