NO ./ruta_a_la_textura_norte
SO ./ruta_a_la_textura_sur
WE      ./ruta_a_la_textura_oeste
EA ./ruta_a_la_textura_este
D ./ruta_a_la_puerta
F 220,100,0
C 225,30,0
        1111111111111111111111111
        1000010000110000000000001
        1011000001110000000000001
        1001000000100000000000001
111111111011000001110000000000001
100000000011000001100111111111111
11110111111111011100000010001
1111011111111101 101010010001
11000000110101011100000010001
10000000000000001100000010001
10000000000000001101010010D01
11000001110101011111011110N0111
11110111 1110101 101111010001
11111111 1111111 111111111111
11111111111111111111111111
11
